1 1 1 1 1 1 1 1 1 1 
1 3 3 3 3 3 3 3 3 1 
1 3 3 3 5 3 3 3 3 1
1 2 1 6 3 4 3 1 2 1 
1 1 1 3 3 3 7 1 3 1 
1 2 3 3 3 3 3 3 3 1 
1 1 1 1 1 1 1 1 1 1
