1 1 1 1 1
1 4 5 2 1
1 3 3 3 1
1 3 5 2 1
1 1 1 1 1
